111111111111111
110000P010011E1
100000000000001
100000011000001
100000000000001
10C000000000001
111111111111111