1111111111111111111111111111111
1000100C101000000000C0110000011
10001000000C0111100011110000001
1001000000001010001010010100001
101CP1000100100110011C010001011
1100010010C01001010000N01001011
101C0010000CC0N0000110C00001011
1100000010101001CC10001000010C1
110000C0000010C100000010N001001
1E0000NNN0000011001C110101N0001
1111111111111111111111111111111